**********
**********
***----***
**********
***-------