*-*****-*-
-*-***-***
*-***-*-*-
********--
***-****-*
**********