*-*-***-*-
-*-***-***
*-*-*-*-*-
--******--
***--***-*
**********