*-*-*-*-*-
-*-*-*-*-*
*-*-*-*-*-
--**--**--
***--**--*